Layer 0: Alpha

,--------------------------------------------------.  
|   `    |   1  |   2  |   3  |   4  |   5  |  L2  |
|--------+------+------+------+------+------+------|
| ESC    |   Q  |   W  |   E  |   R  |   T  |  L1  |
|--------+------+------+------+------+------|      |
| TAB    |   A  |   S  |   D  |   F  |   G  |------|
|--------+------+------+------+------+------| END  |
| LShift |   Z  |   X  |   C  |   V  |   B  |      |
`--------+------+------+------+------+-------------'
  |  L^  | SPER | LAlt |  L2  |  L3  |
  `----------------------------------'
                                     ,-------------.
                                     | ZHTG | MHEN |
                              ,------|------|------|
                              |      |      |      |
                              | SPCE | BCKS |------|
                              |      |      |  L2  |
                              `--------------------'

,--------------------------------------------------.
|  ~   |   6  |   7  |   8  |   9  |   0  |   -    |
|------+------+------+------+------+------+--------|
|  L1  |   Y  |   U  |   I  |   O  |   P  |   \    |
|      |------+------+------+------+------+--------|
|------|   H  |   J  |   K  |   L  |   ;  |    '   |
| HOME |------+------+------+------+------+--------|
|      |   N  |   M  |   ,  |   .  |   /  |    =   |
`-------------+------+------+------+------+--------'
              |  L3  |  L2  | RAlt | SPER |  R^  |
              `----------------------------------'
,-------------.
| HENK | KANA |
|------+------+------.
|      |      |      |
|------| SPAC | ENTR |
|      |      |      |
`--------------------'

Layer 1: Symbol

,--------------------------------------------------.
|        |  !   |  @   |  #   |   $  |  %   |      |
|--------+------+------+------+------+------+------|
|        |      |      |      |      |      |  L1  |
|--------+------+------+------+------+------|      |
|        |      |      |      |      |      |------|
|--------+------+------+------+------+------|      |
|        |      |      |      |      |      |      |
`--------+------+------+------+------+-------------'
  |      |      |      |  L2  |  L3  |
  `----------------------------------'
                                     ,-------------.
                                     |      |      |
                              ,------|------|------|
                              |      |      |      |
                              |      |      |------|
                              |      |      |      |
                              `--------------------'

,--------------------------------------------------.
|      |  ^   |  &   |  *   | INS  | PGUP |   _    |
|------+------+------+------+------+------+--------|
|  L1  |      |   {  |  }   | DEL  | PGDW |   |    |
|      |------+------+------+------+------+--------|
|------|   [  |   (  |  )   |  ]   |  :   |   "    |
|      |------+------+------+------+------+--------|
|      |      |      |  <   |  >   |  ?   |   +    |
`-------------+------+------+------+------+--------'
              |  L3  |  L2  |      |      |      |
              `----------------------------------'
,-------------.
|      |      |
|------+------+------.
|      |      |      |
|------|      |      |
|      |      |      |
`--------------------'

Layer 2: Function

,--------------------------------------------------.
|        |  F1  |  F2  |  F3  |  F4  |  F5  |      |
|--------+------+------+------+------+------+------|
|        |      |      |      |      |      |  L1  |
|--------+------+------+------+------+------|      |
|        |      |      |      |      |      |------|
|--------+------+------+------+------+------|      |
|        |      |      |      |      |      |      |
`--------+------+------+------+------+-------------'
  |      |      |      |  L2  |  L3  |
  `----------------------------------'
                                     ,-------------.
                                     |      |      |
                              ,------|------|------|
                              |      |      |      |
                              |      |      |------|
                              |      |      |      |
                              `--------------------'

,--------------------------------------------------.
|      |  F6  |  F7  |  F8  |  F9  | F10  |  F11   |
|------+------+------+------+------+------+--------|
|  L1  |      |      |  UP  |      |      |  F12   |
|      |------+------+------+------+------+--------|
|------|      | LEFT | DOWN | RGHT |      |        |
|      |------+------+------+------+------+--------|
|      |      |      |      |      |      |        |
`-------------+------+------+------+------+--------'
              |  L3  |  L2  |      |      |      |
              `----------------------------------'
,-------------.
|      |      |
|------+------+------.
|      |      |      |
|------|      |      |
|      |      |      |
`--------------------'
